1110111111111
10010000000C1
1000011111000
1P0011E000001
1111111011111