111111111111
1001000000C1
100C01111101
10000001111
1P0011E00001
111111111111