11111
110E1
10C01
10101
100P1
11111