 NO ./textures/north.xpm
     SO ./textures/south.xpm
WE       ./textures/west.xpm
     EA ./textures/east.xpm

F 5,4,66
C   56,56,055

        1111111111111111111111111
        1000000000110000000000001
        1011000001110000000000001
        1001000000000000000000001
111111111000000001110000000000001
10000000001100000111011111111111
10010111111111011100000010001
10110111110111011101010010001
11000000010101011100000010001
10000000000000001100000010001
10000000000000001101010010001
110000011101010110100110N0111
11110111 1110101 111111010001
11111111 1111111 111111111111