 NO ./textures/north.xpm
     SO ./textures/south.xpm
WE       ./textures/west.xpm
     EA ./textures/east.xpm

F 5,4,66
C   56,56,055

        1111111111111111111111111
        1000000000110000000000001
        1011000001110000000000001
        1001000000000000000000001
11111111011000001110000000000001
100000000011000001110111111111111
10010111111111011100000010001
10110111110111011101010010001
11000000010101011100000010001
10000000000000001100000010001
10000000000000001101010010001
11000001110101011011011110N0111
11110111 1110101 101111010001
11111111 1111111 111111111111