NO     ./textures/7ayt.xpm
SO     ./textures/grey-wall.xpm
WE     ./textures/wall.xpm
EA     ./textures/wally.xpm

F      5,4,66
C      56,56,48

        1111111111111111111111111
        1000000000110000000000001
        1011000001110000000000001
        1001000000000000000000001
111111111000000001110000000000001
100000000001100000111011111111111
10010111111111011100000010001
10110111110111011101010010001
11000000000101011100000010001
10000000000000001100000010001
10000000000000001101010010001
11000001110101011010011000111
11110111 1110101 1111110100E1
11111111 1111111 11111111111