11111111111111111111111111111
1E0000000000000C00000C0000001
10100101001000001010010010101
10100100101010100010010010101
1000000D0C00C000000D0000000C1
10000011111111110000000000001
10000000000111100000D00000001
100011110000000C00000C0000001
101001010010D0001010010010101
10100100101010100010010010101
1P0000000C00C00000000000100C1
11111111111111111111111111111