111111111111
1001000000C1
10C001000101
100010001101
1P0100E00001
111111111111