1111111111
1000011001
1000000011
1PCE110001
1111111111