111111111111
1001000000C1
100C01100101
100000001101
1P0011E00001
111111111111