111111111111
1001000000C1
10C0011D0101
100010001101
1P0100E0D001
111111111111