NO ./path_to_the_north_texture
SO ./path_to_the_south_texture
WE ./path_to_the_west_texture
EA ./path_to_the_east_texture

F 220,100,0
C 225,30,0

        11111111111111111111     
        10000000001100000001     
        10110000011100000001     
        10010000000000000001     
111111111011000001110000000111111
100000000011000001110111100000111
1111011111111101110000001000001  
1111011111111101110101001000001  
1100000011010101110000001000001  
1000000000000000110000001000001  
1000000000000000110101001000001  
11000001110101011111011110N0111  
11110111 1110101 101111010001    
11111111 1111111 111111111111    